R 		1920    1080 

NO	 ./.maps/subject.cub
SO 	./.maps/subject.cub
EA     ./.maps/subject.cub
WE 	./.maps/subject.cub

S  	  	./.maps/subject.cub


F 220,100,0 
C    225,30,0 
1 1 1    1 1 1 1 1 1 1 1 1 1 1 1 1 1 1 1 1 1 1 1 1 1 1 1 1 1 
1 0 0 0 0 0 0 0 0 0 1 1 0 0 0 0 0 0 0 0 0 0 0 0 0 0 0 0 1 
1 0 1 1 0 0 0 0 0 1 1 1 0 0 0 0 0 0 2 0 0 0 0 0 1 0 0 0 1 
1 0 0 10 0 0 0 0 0 0 0 0 0 0 0 0 0 0 0 0 0 0 0 1 0 0 0 1 
1 0 1 1 0 0 0 0 0 1 1 1 0 0 0 0 0 0 0 0 0 0 0 0 1 0 0 0 1 
1 0 0 0 0 0 0 0 0 01 1 0 0 0 0 0 1 1 1 0 1 1 1 1 0 0 0 1 
1 111011111111101110 0 0 0 0 0 	 	1 0 0 0 1 
1 1 1 1 0 1 1 1 1 1 1 1 1 1 0 1 1 1 0 1 0 1 0 0 1 0 0 0 1 
1 1 0 0 0 0 0 0 1 1 0 1 0 1 0 1 1 1 0 0 0 0     0 0 1 0 0 0 1 
1 0 0 0 2 0 0 0 0 0 0 0 0 0 0 0 1 1 0 0 0 0 0 0 1 0 0 0 1 
1 0 0 0 0 0 0 0 0 0 0 0 0 00 0 1 1 0 1 0 1 00 1 0 0 0 1 
1 1 0 0 0 0 0 0 1 1 0 1 0 1 0 1 1 1 1 1 0 1 1 1 1 0 N 0 1 
1 1 1 1 0 1 1 1 1 1 1 1 0 1 0 1 1 1 1 1 0 1 1 1 1 0 0 0 1 
11 1 1 1 1 1 1 1 1 1 1 1 1 1 1 1 1 1 1 1 1 1 1 1 1 1 1 1 

